{
	"maps": {
		"a": [
			"3311111133",
			"vvvwxxwvvv",
			"1112222111",
			"   ayzb   ",
			"  211112  ",
			" c      d ",
			"1112  2111",
			" a      b ",
			"2222112222",
			"    ab    ",
			"1112222111",
			"          "
		],
		"b": [
			"   1111   ",
			"    a     ",
			"   1111   ",
			"     b    ",
			"   1111   ",
			"    a     ",
			"   1111   ",
			"     b    ",
			"   1111   ",
			"    a     ",
			"   1111   ",
			"          "
		],
		"c": [
			"1111      ",
			"      wwww",
			"      1111",
			"vvvv      ",
			"1111      ",
			"      xxxx",
			"      1111",
			"wwww      ",
			"1111      ",
			"      vvvv",
			"      1111",
			"          "
		]
	}
}
