{
	"maps": {
		"a": [
			"   111    ",
			"    vv     ",
			"    11    ",
			"    vv    ",
			"    11    ",
			"          "
		],
		"b": [
			"  111111  ",
			"    d  v  ",
			"  111111  ",
			"  v  c    ",
			"  111111  ",
			"          "
		],
		"c": [
			"  111111  ",
			"     b v  ",
			"  111111  ",
			"    a  v  ",
			"  111111  ",
			"          "
		]
	}
}
