{
	"maps": {
		"a": [
			"  111111  ",
			"  vva vv  ",
			"  111111  ",
			"  vv  vv  ",
			"  11  11  ",
			"          "
		],
		"b": [
			"  111111  ",
			"  vvb vv  ",
			"  111111  ",
			"  vv  vv  ",
			"  111111  ",
			"          "
		],
		"c": [
			"  111111  ",
			"  vvc     ",
			"  11      ",
			"  vv      ",
			"  111111  ",
			"          "
		],
		"d": [
			"  111111  ",
			"  vvd vv  ",
			"  11  11  ",
			"  vv  vv  ",
			"  111111  ",
			"          "
		],
		"e": [
			"  111111  ",
			"  vva     ",
			"  111111  ",
			"  vv      ",
			"  111111  ",
			"          "
		],
		"f": [
			"  111111  ",
			"  vvb     ",
			"  1111    ",
			"  vv      ",
			"  11      ",
			"          "
		],
		"g": [
			"  111111  ",
			"  vvc     ",
			"  11 111  ",
			"  vv  vv  ",
			"  111111  ",
			"          "
		]
	}
}
