{
	"maps": {
		"a": [
			"    11    ",
			"     v    ",
			"     1    ",
			"     v    ",
			"     1    ",
			"          "
		],
		"b": [
			"  111111  ",
			"       v  ",
			"  111111  ",
			"  v       ",
			"  111111  ",
			"          "
		],
		"c": [
			"  111111  ",
			"       v  ",
			"  111111  ",
			"       v  ",
			"  111111  ",
			"          "
		]
	}
}
